                                                   
                   1111111111111                   
                0001000000000000010                
              11011101010111010111011              
            010101000000010100000101000            
           10101010101110101110111011101           
         100000000000100000001000000010101         
        11010101010101110101110101011101011        
       1000001010101010000010100000001000001       
      110101011111111101110101111101110101111      
      000001010101000000000001010100000000000      
     10101011101010111011111010101110101011111     
    0100010000000000010101010000010100010101010    
    0101011111010101111101011111010111011101010    
   100000101010000000101000001010001010100000001   
   101011101011101010101010111011101011101011101   
  00000101000001010100000000000001000100000100000  
  01010101010111011111011111010111110101010111010  
  00010000000001010101010101000000010000010000000  
 1010111010101111101010101011101011101011111011101 
 1010100000100000100000000000100000100010101000001 
 1011111011111011101011101011101011101010101110101 
 1000000010101000000010000000101010000000000010001 
 1011111010101110101011101011101111101110101111101 
 1000100000000010101010000000100000101000000000101 
 1011111011101110111011101011101011101110101011101 
 1000000010100000100000101000100000101010000000101 
 1011111110101010111010111011101011111010101011101 
 1010101010000000000000000000100000001000001010001 
 1010101010101011111110101011111010111010101110111 
 1000000000001010101010000000101000001000100000001 
 1010111010101110101011101011101010111011101010111 
  00010100010100000000010000010000000000000000000  
  11010111011101010101110101110101010101011101011  
  00000001010000010001010000010001010101010000000  
   101011101010101110101110111111111011101110101   
   100010100000101000001000000010100000000010101   
    0101011101011111010111010111011101010111010    
    0000000001010000000001000000000100010100000    
     10101110111110101110111010101111101110101     
      000100000101000101010101000000010000000      
      110101011101110101010101110101110101111      
       1000000000001000000000000000001000001       
        11110101011101011111011111011101011        
         100010000000001010101010000010001         
           10111010101010101110101011101           
            000000000000000100000000010            
              11010101010101010101011              
                0101000000000000000                
                   1111111111111                   
                                                   
